1
CCCCCCCCCC SSSSSSSSSS CCCCCCCCCC SSSSSSSSSS CCCCCCCCCC
CCCCCCCCCC SSSSSSSSSS CCCCCCCCCC SSSSSSSSSS CCCCCCCCCC
CCCCCCCCCC SSSSSSSSSS CCCCCCCCCC SSSSSSSSSS CCCCCCCCCC
CCCCCCCCCC SSSSSSSSSS CCCCCCCCCC SSSSSSSSSS CCCCCCCCCC
CCCCCCCCCC SSSSSSSSSS CCCCCCCCCC SSSSSSSSSS CCCCCCCCCC
CCCCCCCCCC SSSSSSSSSS CCCCCCCCCC SSSSSSSSSS CCCCCCCCCC
CCCCCCCCCC SSSSSSSSSS CCCCCCCCCC SSSSSSSSSS CCCCCCCCCC
CCCCCCCCCC SSSSSSSSSS CCCCCCCCCC SSSSSSSSSS CCCCCCCCCC
CCCCCCCCCC SSSSSSSSSS CCCCCCCCCC SSSSSSSSSS CCCCCCCCCC
CCCCCCCCCC SSSSSSSSSS CCCCCCCCCC SSSSSSSSSS CCCCCCCCCC
......................................................
SSSSSSSSSS CCCCCCCCCC SSSSSSSSSS CCCCCCCCCC SSSSSSSSSS
SSSSSSSSSS CCCCCCCCCC SSSSSSSSSS CCCCCCCCCC SSSSSSSSSS
SSSSSSSSSS CCCCCCCCCC SSSSSSSSSS CCCCCCCCCC SSSSSSSSSS
SSSSSSSSSS CCCCCCCCCC SSSSSSSSSS CCCCCCCCCC SSSSSSSSSS
SSSSSSSSSS CCCCCCCCCC SSSSSSSSSS CCCCCCCCCC SSSSSSSSSS
SSSSSSSSSS CCCCCCCCCC SSSSSSSSSS CCCCCCCCCC SSSSSSSSSS
SSSSSSSSSS CCCCCCCCCC SSSSSSSSSS CCCCCCCCCC SSSSSSSSSS
SSSSSSSSSS CCCCCCCCCC SSSSSSSSSS CCCCCCCCCC SSSSSSSSSS
SSSSSSSSSS CCCCCCCCCC SSSSSSSSSS CCCCCCCCCC SSSSSSSSSS
SSSSSSSSSS CCCCCCCCCC SSSSSSSSSS CCCCCCCCCC SSSSSSSSSS
......................................................
CCCCCCCCCC SSSSSSSSSS CCCCCCCCCC SSSSSSSSSS CCCCCCCCCC
CCCCCCCCCC SSSSSSSSSS CCCCCCCCCC SSSSSSSSSS CCCCCCCCCC
CCCCCCCCCC SSSSSSSSSS CCCCCCCCCC SSSSSSSSSS CCCCCCCCCC
CCCCCCCCCC SSSSSSSSSS CCCCCCCCCC SSSSSSSSSS CCCCCCCCCC
CCCCCCCCCC SSSSSSSSSS CCCCCCCCCC SSSSSSSSSS CCCCCCCCCC
CCCCCCCCCC SSSSSSSSSS CCCCCCCCCC SSSSSSSSSS CCCCCCCCCC
CCCCCCCCCC SSSSSSSSSS CCCCCCCCCC SSSSSSSSSS CCCCCCCCCC
CCCCCCCCCC SSSSSSSSSS CCCCCCCCCC SSSSSSSSSS CCCCCCCCCC
CCCCCCCCCC SSSSSSSSSS CCCCCCCCCC SSSSSSSSSS CCCCCCCCCC
CCCCCCCCCC SSSSSSSSSS CCCCCCCCCC SSSSSSSSSS CCCCCCCCCC
......................................................
SSSSSSSSSS CCCCCCCCCC SSSSSSSSSS CCCCCCCCCC SSSSSSSSSS
SSSSSSSSSS CCCCCCCCCC SSSSSSSSSS CCCCCCCCCC SSSSSSSSSS
SSSSSSSSSS CCCCCCCCCC SSSSSSSSSS CCCCCCCCCC SSSSSSSSSS
SSSSSSSSSS CCCCCCCCCC SSSSSSSSSS CCCCCCCCCC SSSSSSSSSS
SSSSSSSSSS CCCCCCCCCC SSSSSSSSSS CCCCCCCCCC SSSSSSSSSS
SSSSSSSSSS CCCCCCCCCC SSSSSSSSSS CCCCCCCCCC SSSSSSSSSS
SSSSSSSSSS CCCCCCCCCC SSSSSSSSSS CCCCCCCCCC SSSSSSSSSS
SSSSSSSSSS CCCCCCCCCC SSSSSSSSSS CCCCCCCCCC SSSSSSSSSS
SSSSSSSSSS CCCCCCCCCC SSSSSSSSSS CCCCCCCCCC SSSSSSSSSS
SSSSSSSSSS CCCCCCCCCC SSSSSSSSSS CCCCCCCCCC SSSSSSSSSS
......................................................
CCCCCCCCCC SSSSSSSSSS CCCCCCCCCC SSSSSSSSSS CCCCCCCCCC
CCCCCCCCCC SSSSSSSSSS CCCCCCCCCC SSSSSSSSSS CCCCCCCCCC
CCCCCCCCCC SSSSSSSSSS CCCCCCCCCC SSSSSSSSSS CCCCCCCCCC
CCCCCCCCCC SSSSSSSSSS CCCCCCCCCC SSSSSSSSSS CCCCCCCCCC
CCCCCCCCCC SSSSSSSSSS CCCCCCCCCC SSSSSSSSSS CCCCCCCCCC
CCCCCCCCCC SSSSSSSSSS CCCCCCCCCC SSSSSSSSSS CCCCCCCCCC
CCCCCCCCCC SSSSSSSSSS CCCCCCCCCC SSSSSSSSSS CCCCCCCCCC
CCCCCCCCCC SSSSSSSSSS CCCCCCCCCC SSSSSSSSSS CCCCCCCCCC
CCCCCCCCCC SSSSSSSSSS CCCCCCCCCC SSSSSSSSSS CCCCCCCCCC
CCCCCCCCCC SSSSSSSSSS CCCCCCCCCC SSSSSSSSSS CCCCCCCCCC
